3 9 10 9 10 9 10 
3 3 5 6 5 6 3 
5 6 9 12 12 10 3 
9 12 6 9 8 5 6 
5 10 9 6 9 12 10 
11 3 5 10 5 10 3 
5 6 8 6 9 6 3 
3 5 9 12 6 2 3 
5 10 5 12 12 10 3 
9 5 12 10 9 6 3 
3 4 10 5 6 10 3 
3 9 10 1 1 5 6 
3 3 5 12 6 9 10 
3 3 9 12 4 5 10 
3 5 10 9 12 10 3 
3 0 5 6 0 5 6 
5 9 12 14 9 12 6 
1 5 12 8 5 12 10 
3 9 12 10 4 10 3 
3 5 10 3 9 6 3 
3 9 6 3 2 9 6 
9 6 5 6 9 6 11 
5 10 9 12 6 9 6 
5 5 6 12 12 6 2 
